00000000000000000000000000000000000000
00000000000000100000000000000000000000
00000000011100110000000000000000000000
00000111111101111000000000000000000000
00001111111111122111100000000000000000
00000000001111222111000000000010000000
00000000111111121110000000001111000000
00000001112111111000000000111221100000
00000113222211111111111111111122110000
00000113322222111111111000000112000000
00000001333311111000000000000000000000
00000000013331100000000000000000000000
00000000000111000000011000000000000000
00000000000000000000111110000000000000
00000000000000000000001110000000000000
00000000000000000000000100000000000000
00000000000000000000000000000000000000