00000000000000000000000000000000000000
00000000000000100000000000000000000000
00000000011100110000000000000000000000
00000111111101111000000000000000000000
00001111a11111122111100000000000000000
00000000001111222111000000000010000000
00000000111111121110000000001111000000
0000000111211111100000000011122b100000
000001132222111t1111111111111122110000
00000113322222111111111000000112000000
00000001333311111000000000000000000000
00000000013331100000000000000000000000
000000000001t1000000011000000000000000
0000000000000000000011c110000000000000
00000000000000000000001110000000000000
00000000000000000000000100000000000000
00000000000000000000000000000000000000