00000000000000000000000000000000
00000000000000000000000000000000
00000000001000000000000000000000
00000000110000000000000000000000
00000101110000000000000000000000
00001111100000000000000000000000
00000111110000000000000000000000
00000011110000000000000000000000
00000000011000000000000000000000
00000000001100000000000000000000
00000000001000000000000000000000
00000000001100000100000000000000
00000000000100001111000000000000
00000000001100001011110000000000
00000000001000000001111000000000
00000000001100000000110000000000
00000000001010000000000000000000
00000000011000000000000000000000
00000000001000000000000000000000
00000000111000000000000000000000
00000101110000000000000000000000
00001111100000000000000000000000
00000111110000000000000000000000
00000011000000000000000000000000
00000000000000000000000000000000
00000000000000000000000000000000
00000000000000000000000000000000
00000000000000000000000000000000
00000000000000000000000000000000
00000000000000000000000000000000
00000000000000000000000000000000
00000000000000000000000000000000