00000000000000010000000000000000000000
00000000000000110000000000000000000000
00000000011100100000000000000000000000
00000111111101101000000000000000000000
00001111111111101000000000000000000000
00000000001111111000000000000000000000
00000000111111111100000000000000000000
00000001111111111000000000000000000000
00000111111111000000000000000000000000
00000111111100000000000000000000000000
00000001111000000000000000000000000000
00000000000000000000000000000000000000
00000000000000000000011000000000000000
00000000000000000000111110000000000000
00000000000000000000001110000000000000
00000000000000000000000100000000000000
00000000000000000000000000000000000000
00000000000000000000000000000000000000
00000000000000000000000000000000000000
00000001110111101001010000000000000000
00000001010100101001010000000000000000
00000001110111101001010000000000000000
00000001000100101001010000000000000000
00000001000100100110011110000000000000
00000000000000000000000000000000000000
00000000000000000000000000000000000000