0000000000000000
0000000000000000
0000000000100000
0000000011000000
0000010111000000
0000111110000000
0000011111000000
0000001100000000
0000000000000000
0000000000000000
0000000000000000
0000000000000000
0000000000000000
0000000000000000
0000000000000000
0000000000000000